###############################################
#                                             #
######################### ############## ######
#                                             #
########## ##### ############### ####### ######
###  ####      #          ############## ######
###                  #                        #
############# ###      $       ################
#             #        #                      #
############# ######## ################## #####
#                                             #
########## ############# ######## #############
#          #                            #     #
#                          #                  #
#                 #    #                      #
### ######## ######## ################# ### ###
#                               @            ##
############################################### 